start_time,end_time,run_time,program_string,lr,epochs,width_height,val_split,VAL_LOSS,RAM_USAGE,RUNTIME,exit_code,signal,hostname
1739368175,1739368368,193,bash /home/s3811141/repos/OmniOpt/ax/.tests/example_network/run.sh --learning_rate=0.04413507878780365 --epochs=33 --validation_split=0.2 --width=10 --height=10,0.04413507878780365,33,10,0.2,1.5268,637.61,193,0,None,arbeitsrechner
1739368380,1739368535,155,bash /home/s3811141/repos/OmniOpt/ax/.tests/example_network/run.sh --learning_rate=0.09681823467835785 --epochs=43 --validation_split=0.2 --width=20 --height=20,0.09681823467835785,43,20,0.2,1.5283,657.1,155,0,None,arbeitsrechner
1739368540,1739368591,51,bash /home/s3811141/repos/OmniOpt/ax/.tests/example_network/run.sh --learning_rate=0.06313138408586383 --epochs=36 --validation_split=0.2 --width=5 --height=5,0.06313138408586383,36,5,0.2,1.4988,638.43,51,0,None,arbeitsrechner
1739368594,1739368654,60,bash /home/s3811141/repos/OmniOpt/ax/.tests/example_network/run.sh --learning_rate=0.015129622351378203 --epochs=45 --validation_split=0.2 --width=15 --height=15,0.015129622351378203,45,15,0.2,1.009,654.65,60,0,None,arbeitsrechner
1739368659,1739368720,61,bash /home/s3811141/repos/OmniOpt/ax/.tests/example_network/run.sh --learning_rate=0.0031992180272936823 --epochs=39 --validation_split=0.2 --width=20 --height=20,0.0031992180272936823,39,20,0.2,0.0942,669.8,61,0,None,arbeitsrechner
1739368724,1739368801,77,bash /home/s3811141/repos/OmniOpt/ax/.tests/example_network/run.sh --learning_rate=0.0558932451531291 --epochs=50 --validation_split=0.2 --width=10 --height=10,0.0558932451531291,50,10,0.2,1.5237,637.84,77,0,None,arbeitsrechner
1739368806,1739368859,53,bash /home/s3811141/repos/OmniOpt/ax/.tests/example_network/run.sh --learning_rate=0.0848895462229848 --epochs=31 --validation_split=0.2 --width=15 --height=15,0.0848895462229848,31,15,0.2,1.5487,652.6,53,0,None,arbeitsrechner
1739368864,1739368926,62,bash /home/s3811141/repos/OmniOpt/ax/.tests/example_network/run.sh --learning_rate=0.03690132666379214 --epochs=42 --validation_split=0.2 --width=5 --height=5,0.03690132666379214,42,5,0.2,1.1383,639.63,62,0,None,arbeitsrechner
1739368931,1739368991,60,bash /home/s3811141/repos/OmniOpt/ax/.tests/example_network/run.sh --learning_rate=0.030494145303964618 --epochs=37 --validation_split=0.2 --width=15 --height=15,0.030494145303964618,37,15,0.2,1.0735,651.68,60,0,None,arbeitsrechner
1739368996,1739369069,73,bash /home/s3811141/repos/OmniOpt/ax/.tests/example_network/run.sh --learning_rate=0.078598340600729 --epochs=47 --validation_split=0.2 --width=5 --height=5,0.078598340600729,47,5,0.2,1.539,642.62,73,0,None,arbeitsrechner
1739369075,1739369122,47,bash /home/s3811141/repos/OmniOpt/ax/.tests/example_network/run.sh --learning_rate=0.06228209473192692 --epochs=34 --validation_split=0.2 --width=20 --height=20,0.06228209473192692,34,20,0.2,1.5236,660.28,47,0,None,arbeitsrechner
1739369126,1739369180,54,bash /home/s3811141/repos/OmniOpt/ax/.tests/example_network/run.sh --learning_rate=0.009508707001805306 --epochs=45 --validation_split=0.2 --width=10 --height=10,0.009508707001805306,45,10,0.2,0.2004,637.62,54,0,None,arbeitsrechner
1739369185,1739369224,39,bash /home/s3811141/repos/OmniOpt/ax/.tests/example_network/run.sh --learning_rate=0.021429982874542477 --epochs=30 --validation_split=0.2 --width=5 --height=5,0.021429982874542477,30,5,0.2,1.5231,643.49,39,0,None,arbeitsrechner
1739369229,1739369279,50,bash /home/s3811141/repos/OmniOpt/ax/.tests/example_network/run.sh --learning_rate=0.06952330628409982 --epochs=40 --validation_split=0.2 --width=15 --height=15,0.06952330628409982,40,15,0.2,1.5307,651.82,50,0,None,arbeitsrechner
1739369285,1739369346,61,bash /home/s3811141/repos/OmniOpt/ax/.tests/example_network/run.sh --learning_rate=0.0905240041203797 --epochs=38 --validation_split=0.2 --width=10 --height=10,0.0905240041203797,38,10,0.2,1.5276,637.25,61,0,None,arbeitsrechner
1739369351,1739369436,85,bash /home/s3811141/repos/OmniOpt/ax/.tests/example_network/run.sh --learning_rate=0.03773707421496511 --epochs=48 --validation_split=0.2 --width=20 --height=20,0.03773707421496511,48,20,0.2,1.5257,667.01,85,0,None,arbeitsrechner
1739369443,1739369510,67,bash /home/s3811141/repos/OmniOpt/ax/.tests/example_network/run.sh --learning_rate=0.042851168848574164 --epochs=38 --validation_split=0.2 --width=5 --height=5,0.042851168848574164,38,5,0.2,1.5248,640.61,67,0,None,arbeitsrechner
1739369517,1739369600,83,bash /home/s3811141/repos/OmniOpt/ax/.tests/example_network/run.sh --learning_rate=0.09163265768438578 --epochs=49 --validation_split=0.2 --width=15 --height=15,0.09163265768438578,49,15,0.2,1.531,648.78,83,0,None,arbeitsrechner
1739369608,1739369664,56,bash /home/s3811141/repos/OmniOpt/ax/.tests/example_network/run.sh --learning_rate=0.07376005705446005 --epochs=30 --validation_split=0.2 --width=10 --height=10,0.07376005705446005,30,10,0.2,1.5259,636.34,56,0,None,arbeitsrechner
1739369670,1739369731,61,bash /home/s3811141/repos/OmniOpt/ax/.tests/example_network/run.sh --learning_rate=0.02342218067497015 --epochs=41 --validation_split=0.2 --width=20 --height=20,0.02342218067497015,41,20,0.2,1.4488,666.04,61,0,None,arbeitsrechner
1739369768,1739369815,47,bash /home/s3811141/repos/OmniOpt/ax/.tests/example_network/run.sh --learning_rate=0.005433621215199059 --epochs=38 --validation_split=0.2 --width=10 --height=10,0.005433621215199059,38,10,0.2,0.3855,637.46,47,0,None,arbeitsrechner
1739369848,1739369918,70,bash /home/s3811141/repos/OmniOpt/ax/.tests/example_network/run.sh --learning_rate=0.0038430075132129464 --epochs=46 --validation_split=0.2 --width=10 --height=10,0.0038430075132129464,46,10,0.2,0.105,636.57,70,0,None,arbeitsrechner
1739369972,1739370088,116,bash /home/s3811141/repos/OmniOpt/ax/.tests/example_network/run.sh --learning_rate=0.005574275526153011 --epochs=50 --validation_split=0.2 --width=5 --height=5,0.005574275526153011,50,5,0.2,0.2956,643.53,116,0,None,arbeitsrechner
1739370141,1739370219,78,bash /home/s3811141/repos/OmniOpt/ax/.tests/example_network/run.sh --learning_rate=0.009849095001218134 --epochs=34 --validation_split=0.2 --width=10 --height=10,0.009849095001218134,34,10,0.2,0.2448,637.03,78,0,None,arbeitsrechner
1739370278,1739370348,70,bash /home/s3811141/repos/OmniOpt/ax/.tests/example_network/run.sh --learning_rate=0.006991562841436698 --epochs=30 --validation_split=0.2 --width=5 --height=5,0.006991562841436698,30,5,0.2,0.5488,640.23,70,0,None,arbeitsrechner
1739370413,1739370520,107,bash /home/s3811141/repos/OmniOpt/ax/.tests/example_network/run.sh --learning_rate=0.0060393558820197165 --epochs=50 --validation_split=0.2 --width=15 --height=15,0.0060393558820197165,50,15,0.2,0.1793,652.3,107,0,None,arbeitsrechner
1739370581,1739370674,93,bash /home/s3811141/repos/OmniOpt/ax/.tests/example_network/run.sh --learning_rate=0.007431387764042925 --epochs=41 --validation_split=0.2 --width=10 --height=10,0.007431387764042925,41,10,0.2,1.523,637.02,93,0,None,arbeitsrechner
1739370724,1739370805,81,bash /home/s3811141/repos/OmniOpt/ax/.tests/example_network/run.sh --learning_rate=0 --epochs=37 --validation_split=0.2 --width=10 --height=10,0,37,10,0.2,2.0015,637.61,81,0,None,arbeitsrechner
1739370874,1739370979,105,bash /home/s3811141/repos/OmniOpt/ax/.tests/example_network/run.sh --learning_rate=0 --epochs=50 --validation_split=0.2 --width=10 --height=10,0,50,10,0.2,1.6226,638.31,105,0,None,arbeitsrechner
1739371043,1739371153,110,bash /home/s3811141/repos/OmniOpt/ax/.tests/example_network/run.sh --learning_rate=0.01890271843087367 --epochs=50 --validation_split=0.2 --width=10 --height=10,0.01890271843087367,50,10,0.2,0.8675,638.25,110,0,None,arbeitsrechner
1739371224,1739371298,74,bash /home/s3811141/repos/OmniOpt/ax/.tests/example_network/run.sh --learning_rate=0.008475971962715436 --epochs=32 --validation_split=0.2 --width=15 --height=15,0.008475971962715436,32,15,0.2,0.3148,651.18,74,0,None,arbeitsrechner
1739371346,1739371424,78,bash /home/s3811141/repos/OmniOpt/ax/.tests/example_network/run.sh --learning_rate=0.011190751074674002 --epochs=38 --validation_split=0.2 --width=10 --height=10,0.011190751074674002,38,10,0.2,0.9226,637.15,78,0,None,arbeitsrechner
1739371486,1739371571,85,bash /home/s3811141/repos/OmniOpt/ax/.tests/example_network/run.sh --learning_rate=0.004338138322124452 --epochs=37 --validation_split=0.2 --width=10 --height=10,0.004338138322124452,37,10,0.2,0.1019,635.54,85,0,None,arbeitsrechner
1739371625,1739371711,86,bash /home/s3811141/repos/OmniOpt/ax/.tests/example_network/run.sh --learning_rate=0.0036879680360411985 --epochs=38 --validation_split=0.2 --width=10 --height=10,0.0036879680360411985,38,10,0.2,0.5217,636.4,86,0,None,arbeitsrechner
1739371781,1739371851,70,bash /home/s3811141/repos/OmniOpt/ax/.tests/example_network/run.sh --learning_rate=0.017434409786313148 --epochs=30 --validation_split=0.2 --width=10 --height=10,0.017434409786313148,30,10,0.2,0.9084,636.26,70,0,None,arbeitsrechner
1739371913,1739372001,88,bash /home/s3811141/repos/OmniOpt/ax/.tests/example_network/run.sh --learning_rate=0.03316806780216257 --epochs=39 --validation_split=0.2 --width=10 --height=10,0.03316806780216257,39,10,0.2,1.0632,637.3,88,0,None,arbeitsrechner
1739372067,1739372161,94,bash /home/s3811141/repos/OmniOpt/ax/.tests/example_network/run.sh --learning_rate=0.004375794397376246 --epochs=44 --validation_split=0.2 --width=10 --height=10,0.004375794397376246,44,10,0.2,0.2307,637.98,94,0,None,arbeitsrechner
1739372230,1739372309,79,bash /home/s3811141/repos/OmniOpt/ax/.tests/example_network/run.sh --learning_rate=0.004395536863282607 --epochs=36 --validation_split=0.2 --width=10 --height=10,0.004395536863282607,36,10,0.2,0.4987,636.64,79,0,None,arbeitsrechner
1739372384,1739372475,91,bash /home/s3811141/repos/OmniOpt/ax/.tests/example_network/run.sh --learning_rate=0.010390792809766236 --epochs=46 --validation_split=0.2 --width=10 --height=10,0.010390792809766236,46,10,0.2,0.3261,637.55,91,0,None,arbeitsrechner
1739372537,1739372621,84,bash /home/s3811141/repos/OmniOpt/ax/.tests/example_network/run.sh --learning_rate=0.004269449698548517 --epochs=40 --validation_split=0.2 --width=10 --height=10,0.004269449698548517,40,10,0.2,0.2634,636.23,84,0,None,arbeitsrechner
1739372702,1739372793,91,bash /home/s3811141/repos/OmniOpt/ax/.tests/example_network/run.sh --learning_rate=0.01811837391806933 --epochs=43 --validation_split=0.2 --width=10 --height=10,0.01811837391806933,43,10,0.2,1.5229,637.74,91,0,None,arbeitsrechner
1739372863,1739372923,60,bash /home/s3811141/repos/OmniOpt/ax/.tests/example_network/run.sh --learning_rate=0.0332002009845822 --epochs=30 --validation_split=0.2 --width=5 --height=5,0.0332002009845822,30,5,0.2,0.4323,636.55,60,0,None,arbeitsrechner
1739373014,1739373080,66,bash /home/s3811141/repos/OmniOpt/ax/.tests/example_network/run.sh --learning_rate=0.01579210391455151 --epochs=30 --validation_split=0.2 --width=5 --height=5,0.01579210391455151,30,5,0.2,0.8833,642.75,66,0,None,arbeitsrechner
1739373180,1739373264,84,bash /home/s3811141/repos/OmniOpt/ax/.tests/example_network/run.sh --learning_rate=0.025881819435112186 --epochs=40 --validation_split=0.2 --width=5 --height=5,0.025881819435112186,40,5,0.2,0.5405,637.95,84,0,None,arbeitsrechner
1739373363,1739373429,66,bash /home/s3811141/repos/OmniOpt/ax/.tests/example_network/run.sh --learning_rate=0 --epochs=30 --validation_split=0.2 --width=5 --height=5,0,30,5,0.2,1.699,645.57,66,0,None,arbeitsrechner
1739373504,1739373599,95,bash /home/s3811141/repos/OmniOpt/ax/.tests/example_network/run.sh --learning_rate=0.026693608762824186 --epochs=44 --validation_split=0.2 --width=15 --height=15,0.026693608762824186,44,15,0.2,1.5255,648.42,95,0,None,arbeitsrechner
1739373686,1739373769,83,bash /home/s3811141/repos/OmniOpt/ax/.tests/example_network/run.sh --learning_rate=0.004415962198260673 --epochs=39 --validation_split=0.2 --width=15 --height=15,0.004415962198260673,39,15,0.2,0.2294,650.3,83,0,None,arbeitsrechner
1739373860,1739373926,66,bash /home/s3811141/repos/OmniOpt/ax/.tests/example_network/run.sh --learning_rate=0.004221260205281655 --epochs=30 --validation_split=0.2 --width=10 --height=10,0.004221260205281655,30,10,0.2,0.1339,636.81,66,0,None,arbeitsrechner
1739374027,1739374131,104,bash /home/s3811141/repos/OmniOpt/ax/.tests/example_network/run.sh --learning_rate=0.05050275665379291 --epochs=50 --validation_split=0.2 --width=5 --height=5,0.05050275665379291,50,5,0.2,1.5258,648.56,104,0,None,arbeitsrechner
1739374222,1739374303,81,bash /home/s3811141/repos/OmniOpt/ax/.tests/example_network/run.sh --learning_rate=0.06631136563913938 --epochs=37 --validation_split=0.2 --width=10 --height=10,0.06631136563913938,37,10,0.2,1.5346,636.98,81,0,None,arbeitsrechner
1739374399,1739374465,66,bash /home/s3811141/repos/OmniOpt/ax/.tests/example_network/run.sh --learning_rate=0.025241550474752916 --epochs=30 --validation_split=0.2 --width=5 --height=5,0.025241550474752916,30,5,0.2,1.0835,638.72,66,0,None,arbeitsrechner
1739374547,1739374613,66,bash /home/s3811141/repos/OmniOpt/ax/.tests/example_network/run.sh --learning_rate=0.025930299168467827 --epochs=30 --validation_split=0.2 --width=10 --height=10,0.025930299168467827,30,10,0.2,0.8578,636.56,66,0,None,arbeitsrechner
1739374720,1739374790,70,bash /home/s3811141/repos/OmniOpt/ax/.tests/example_network/run.sh --learning_rate=0.08160618909336498 --epochs=31 --validation_split=0.2 --width=10 --height=10,0.08160618909336498,31,10,0.2,1.5285,636.86,70,0,None,arbeitsrechner
1739374878,1739374944,66,bash /home/s3811141/repos/OmniOpt/ax/.tests/example_network/run.sh --learning_rate=0.1 --epochs=30 --validation_split=0.2 --width=5 --height=5,0.1,30,5,0.2,1.5321,640.93,66,0,None,arbeitsrechner
1739375051,1739375118,67,bash /home/s3811141/repos/OmniOpt/ax/.tests/example_network/run.sh --learning_rate=0.0040003177607413265 --epochs=30 --validation_split=0.2 --width=15 --height=15,0.0040003177607413265,30,15,0.2,0.1149,649.91,67,0,None,arbeitsrechner
1739375218,1739375286,68,bash /home/s3811141/repos/OmniOpt/ax/.tests/example_network/run.sh --learning_rate=0.004478961934017735 --epochs=30 --validation_split=0.2 --width=20 --height=20,0.004478961934017735,30,20,0.2,0.5689,657.36,68,0,None,arbeitsrechner
1739375400,1739375468,68,bash /home/s3811141/repos/OmniOpt/ax/.tests/example_network/run.sh --learning_rate=0.03375628999700002 --epochs=30 --validation_split=0.2 --width=15 --height=15,0.03375628999700002,30,15,0.2,0.9201,650.88,68,0,None,arbeitsrechner
1739375568,1739375637,69,bash /home/s3811141/repos/OmniOpt/ax/.tests/example_network/run.sh --learning_rate=0.010739091508087925 --epochs=30 --validation_split=0.2 --width=20 --height=20,0.010739091508087925,30,20,0.2,0.5611,657.36,69,0,None,arbeitsrechner
1739375756,1739375822,66,bash /home/s3811141/repos/OmniOpt/ax/.tests/example_network/run.sh --learning_rate=0.004140367203913436 --epochs=30 --validation_split=0.2 --width=5 --height=5,0.004140367203913436,30,5,0.2,0.1106,637.55,66,0,None,arbeitsrechner
1739375923,1739375990,67,bash /home/s3811141/repos/OmniOpt/ax/.tests/example_network/run.sh --learning_rate=0.017988610104006694 --epochs=30 --validation_split=0.2 --width=15 --height=15,0.017988610104006694,30,15,0.2,0.4582,647.04,67,0,None,arbeitsrechner
1739376100,1739376170,70,bash /home/s3811141/repos/OmniOpt/ax/.tests/example_network/run.sh --learning_rate=0 --epochs=30 --validation_split=0.2 --width=20 --height=20,0,30,20,0.2,1.9322,663.88,70,0,None,arbeitsrechner
1739376257,1739376326,69,bash /home/s3811141/repos/OmniOpt/ax/.tests/example_network/run.sh --learning_rate=0.00415753339407889 --epochs=31 --validation_split=0.2 --width=10 --height=10,0.00415753339407889,31,10,0.2,0.2896,636.75,69,0,None,arbeitsrechner
1739376417,1739376494,77,bash /home/s3811141/repos/OmniOpt/ax/.tests/example_network/run.sh --learning_rate=0.004354369428488793 --epochs=35 --validation_split=0.2 --width=10 --height=10,0.004354369428488793,35,10,0.2,0.0664,636.77,77,0,None,arbeitsrechner
1739376585,1739376675,90,bash /home/s3811141/repos/OmniOpt/ax/.tests/example_network/run.sh --learning_rate=0.004038106279175465 --epochs=42 --validation_split=0.2 --width=10 --height=10,0.004038106279175465,42,10,0.2,0.3917,638.18,90,0,None,arbeitsrechner
1739376792,1739376858,66,bash /home/s3811141/repos/OmniOpt/ax/.tests/example_network/run.sh --learning_rate=0.05948829598011899 --epochs=30 --validation_split=0.2 --width=5 --height=5,0.05948829598011899,30,5,0.2,1.4018,644.16,66,0,None,arbeitsrechner
1739376971,1739377042,71,bash /home/s3811141/repos/OmniOpt/ax/.tests/example_network/run.sh --learning_rate=0.07205056969105972 --epochs=32 --validation_split=0.2 --width=5 --height=5,0.07205056969105972,32,5,0.2,1.5257,634.58,71,0,None,arbeitsrechner
1739377163,1739377243,80,bash /home/s3811141/repos/OmniOpt/ax/.tests/example_network/run.sh --learning_rate=0.1 --epochs=37 --validation_split=0.2 --width=10 --height=10,0.1,37,10,0.2,1.5445,636.95,80,0,None,arbeitsrechner
1739377331,1739377426,95,bash /home/s3811141/repos/OmniOpt/ax/.tests/example_network/run.sh --learning_rate=0.004173152949174463 --epochs=45 --validation_split=0.2 --width=5 --height=5,0.004173152949174463,45,5,0.2,0.1396,640.39,95,0,None,arbeitsrechner
1739377537,1739377638,101,bash /home/s3811141/repos/OmniOpt/ax/.tests/example_network/run.sh --learning_rate=0.07711200779320691 --epochs=47 --validation_split=0.2 --width=10 --height=10,0.07711200779320691,47,10,0.2,1.5334,637.46,101,0,None,arbeitsrechner
1739377743,1739377809,66,bash /home/s3811141/repos/OmniOpt/ax/.tests/example_network/run.sh --learning_rate=0.017981078820320014 --epochs=30 --validation_split=0.2 --width=5 --height=5,0.017981078820320014,30,5,0.2,0.2451,640.83,66,0,None,arbeitsrechner
1739377923,1739377993,70,bash /home/s3811141/repos/OmniOpt/ax/.tests/example_network/run.sh --learning_rate=0.08790265500828023 --epochs=32 --validation_split=0.2 --width=5 --height=5,0.08790265500828023,32,5,0.2,1.533,633.44,70,0,None,arbeitsrechner
1739378079,1739378158,79,bash /home/s3811141/repos/OmniOpt/ax/.tests/example_network/run.sh --learning_rate=0.004244820870343096 --epochs=36 --validation_split=0.2 --width=5 --height=5,0.004244820870343096,36,5,0.2,0.1818,635.38,79,0,None,arbeitsrechner
1739378280,1739378353,73,bash /home/s3811141/repos/OmniOpt/ax/.tests/example_network/run.sh --learning_rate=0.03505462848239198 --epochs=33 --validation_split=0.2 --width=5 --height=5,0.03505462848239198,33,5,0.2,1.0352,643.12,73,0,None,arbeitsrechner
1739378462,1739378566,104,bash /home/s3811141/repos/OmniOpt/ax/.tests/example_network/run.sh --learning_rate=0.033266246193503136 --epochs=50 --validation_split=0.2 --width=5 --height=5,0.033266246193503136,50,5,0.2,1.5273,647.47,104,0,None,arbeitsrechner
1739378681,1739378777,96,bash /home/s3811141/repos/OmniOpt/ax/.tests/example_network/run.sh --learning_rate=0.09377078546995045 --epochs=45 --validation_split=0.2 --width=5 --height=5,0.09377078546995045,45,5,0.2,1.5457,641.71,96,0,None,arbeitsrechner
1739378890,1739378961,71,bash /home/s3811141/repos/OmniOpt/ax/.tests/example_network/run.sh --learning_rate=0.07514856014905796 --epochs=31 --validation_split=0.2 --width=15 --height=15,0.07514856014905796,31,15,0.2,1.5258,651.1,71,0,None,arbeitsrechner
1739379074,1739379153,79,bash /home/s3811141/repos/OmniOpt/ax/.tests/example_network/run.sh --learning_rate=0.004091062616496995 --epochs=37 --validation_split=0.2 --width=5 --height=5,0.004091062616496995,37,5,0.2,0.1303,641.83,79,0,None,arbeitsrechner
1739379276,1739379384,108,bash /home/s3811141/repos/OmniOpt/ax/.tests/example_network/run.sh --learning_rate=0.05929024057971634 --epochs=50 --validation_split=0.2 --width=15 --height=15,0.05929024057971634,50,15,0.2,1.527,654.19,108,0,None,arbeitsrechner
1739379495,1739379565,70,bash /home/s3811141/repos/OmniOpt/ax/.tests/example_network/run.sh --learning_rate=0.0042740169835449255 --epochs=31 --validation_split=0.2 --width=5 --height=5,0.0042740169835449255,31,5,0.2,0.1422,642.47,70,0,None,arbeitsrechner
1739379663,1739379737,74,bash /home/s3811141/repos/OmniOpt/ax/.tests/example_network/run.sh --learning_rate=0.010024351614629506 --epochs=34 --validation_split=0.2 --width=5 --height=5,0.010024351614629506,34,5,0.2,0.1602,641,74,0,None,arbeitsrechner
1739379845,1739379936,91,bash /home/s3811141/repos/OmniOpt/ax/.tests/example_network/run.sh --learning_rate=0.004017834473747884 --epochs=43 --validation_split=0.2 --width=5 --height=5,0.004017834473747884,43,5,0.2,0.1256,641.91,91,0,None,arbeitsrechner
1739380039,1739380127,88,bash /home/s3811141/repos/OmniOpt/ax/.tests/example_network/run.sh --learning_rate=0.004042876663708404 --epochs=40 --validation_split=0.2 --width=15 --height=15,0.004042876663708404,40,15,0.2,1.128,651.59,88,0,None,arbeitsrechner
1739380261,1739380343,82,bash /home/s3811141/repos/OmniOpt/ax/.tests/example_network/run.sh --learning_rate=0.018388421590637628 --epochs=37 --validation_split=0.2 --width=5 --height=5,0.018388421590637628,37,5,0.2,0.3127,641.79,82,0,None,arbeitsrechner
1739380445,1739380532,87,bash /home/s3811141/repos/OmniOpt/ax/.tests/example_network/run.sh --learning_rate=0.005298594285563752 --epochs=41 --validation_split=0.2 --width=5 --height=5,0.005298594285563752,41,5,0.2,0.2318,645.65,87,0,None,arbeitsrechner
1739380649,1739380750,101,bash /home/s3811141/repos/OmniOpt/ax/.tests/example_network/run.sh --learning_rate=0.004151619836198207 --epochs=46 --validation_split=0.2 --width=15 --height=15,0.004151619836198207,46,15,0.2,0.1853,650.85,101,0,None,arbeitsrechner
1739380878,1739380947,69,bash /home/s3811141/repos/OmniOpt/ax/.tests/example_network/run.sh --learning_rate=0.02675046826457365 --epochs=30 --validation_split=0.2 --width=15 --height=15,0.02675046826457365,30,15,0.2,1.5252,651.67,69,0,None,arbeitsrechner
1739381075,1739381157,82,bash /home/s3811141/repos/OmniOpt/ax/.tests/example_network/run.sh --learning_rate=0.017854003009658236 --epochs=37 --validation_split=0.2 --width=15 --height=15,0.017854003009658236,37,15,0.2,0.6429,648.71,82,0,None,arbeitsrechner
1739381282,1739381351,69,bash /home/s3811141/repos/OmniOpt/ax/.tests/example_network/run.sh --learning_rate=0.01813310015422037 --epochs=30 --validation_split=0.2 --width=20 --height=20,0.01813310015422037,30,20,0.2,0.9645,659.1,69,0,None,arbeitsrechner
1739381484,1739381582,98,bash /home/s3811141/repos/OmniOpt/ax/.tests/example_network/run.sh --learning_rate=0.06731340061188866 --epochs=46 --validation_split=0.2 --width=5 --height=5,0.06731340061188866,46,5,0.2,1.524,639.81,98,0,None,arbeitsrechner
1739381702,1739381789,87,bash /home/s3811141/repos/OmniOpt/ax/.tests/example_network/run.sh --learning_rate=0.08098243012304283 --epochs=40 --validation_split=0.2 --width=15 --height=15,0.08098243012304283,40,15,0.2,1.5467,652.52,87,0,None,arbeitsrechner
1739381927,1739381995,68,bash /home/s3811141/repos/OmniOpt/ax/.tests/example_network/run.sh --learning_rate=0.09340980816454372 --epochs=30 --validation_split=0.2 --width=10 --height=10,0.09340980816454372,30,10,0.2,1.5298,636.33,68,0,None,arbeitsrechner
1739382112,1739382181,69,bash /home/s3811141/repos/OmniOpt/ax/.tests/example_network/run.sh --learning_rate=0.010090315924567042 --epochs=30 --validation_split=0.2 --width=10 --height=10,0.010090315924567042,30,10,0.2,0.2843,637.03,69,0,None,arbeitsrechner
1739382319,1739382387,68,bash /home/s3811141/repos/OmniOpt/ax/.tests/example_network/run.sh --learning_rate=0.01054894867400469 --epochs=30 --validation_split=0.2 --width=15 --height=15,0.01054894867400469,30,15,0.2,0.8658,653.87,68,0,None,arbeitsrechner
1739382513,1739382584,71,bash /home/s3811141/repos/OmniOpt/ax/.tests/example_network/run.sh --learning_rate=0.03257222642880556 --epochs=30 --validation_split=0.2 --width=20 --height=20,0.03257222642880556,30,20,0.2,1.5235,659.62,71,0,None,arbeitsrechner
1739382698,1739382776,78,bash /home/s3811141/repos/OmniOpt/ax/.tests/example_network/run.sh --learning_rate=0.004434013516873897 --epochs=35 --validation_split=0.2 --width=5 --height=5,0.004434013516873897,35,5,0.2,0.1154,636.45,78,0,None,arbeitsrechner
1739382883,1739382984,101,bash /home/s3811141/repos/OmniOpt/ax/.tests/example_network/run.sh --learning_rate=0.004167630486968534 --epochs=48 --validation_split=0.2 --width=5 --height=5,0.004167630486968534,48,5,0.2,0.1551,648.25,101,0,None,arbeitsrechner
1739383108,1739383194,86,bash /home/s3811141/repos/OmniOpt/ax/.tests/example_network/run.sh --learning_rate=0.05337594627033147 --epochs=39 --validation_split=0.2 --width=15 --height=15,0.05337594627033147,39,15,0.2,1.5256,651.92,86,0,None,arbeitsrechner
1739383315,1739383392,77,bash /home/s3811141/repos/OmniOpt/ax/.tests/example_network/run.sh --learning_rate=0.06542201090989316 --epochs=34 --validation_split=0.2 --width=15 --height=15,0.06542201090989316,34,15,0.2,1.523,650.46,77,0,None,arbeitsrechner
1739383530,1739383613,83,bash /home/s3811141/repos/OmniOpt/ax/.tests/example_network/run.sh --learning_rate=0.0573064953651107 --epochs=39 --validation_split=0.2 --width=5 --height=5,0.0573064953651107,39,5,0.2,1.5262,638.04,83,0,None,arbeitsrechner
1739383748,1739383837,89,bash /home/s3811141/repos/OmniOpt/ax/.tests/example_network/run.sh --learning_rate=0.03552036416396407 --epochs=41 --validation_split=0.2 --width=15 --height=15,0.03552036416396407,41,15,0.2,1.5251,652.33,89,0,None,arbeitsrechner
1739383977,1739384060,83,bash /home/s3811141/repos/OmniOpt/ax/.tests/example_network/run.sh --learning_rate=0.009964825528525088 --epochs=36 --validation_split=0.2 --width=20 --height=20,0.009964825528525088,36,20,0.2,0.5992,660.01,83,0,None,arbeitsrechner
1739384195,1739384262,67,bash /home/s3811141/repos/OmniOpt/ax/.tests/example_network/run.sh --learning_rate=0.06529378445424164 --epochs=30 --validation_split=0.2 --width=5 --height=5,0.06529378445424164,30,5,0.2,1.5359,642.39,67,0,None,arbeitsrechner
1739384402,1739384477,75,bash /home/s3811141/repos/OmniOpt/ax/.tests/example_network/run.sh --learning_rate=0.018402424241769626 --epochs=34 --validation_split=0.2 --width=10 --height=10,0.018402424241769626,34,10,0.2,1.0445,637.24,75,0,None,arbeitsrechner
1739384618,1739384687,69,bash /home/s3811141/repos/OmniOpt/ax/.tests/example_network/run.sh --learning_rate=0.019256727865895204 --epochs=30 --validation_split=0.2 --width=5 --height=5,0.019256727865895204,30,5,0.2,0.3661,640,69,0,None,arbeitsrechner
1739384844,1739384913,69,bash /home/s3811141/repos/OmniOpt/ax/.tests/example_network/run.sh --learning_rate=0.06781576048662766 --epochs=30 --validation_split=0.2 --width=20 --height=20,0.06781576048662766,30,20,0.2,1.5291,662.18,69,0,None,arbeitsrechner
1739385055,1739385124,69,bash /home/s3811141/repos/OmniOpt/ax/.tests/example_network/run.sh --learning_rate=0.09083134009129078 --epochs=30 --validation_split=0.2 --width=15 --height=15,0.09083134009129078,30,15,0.2,1.5271,649.52,69,0,None,arbeitsrechner
1739385275,1739385346,71,bash /home/s3811141/repos/OmniOpt/ax/.tests/example_network/run.sh --learning_rate=0.0260036413547907 --epochs=32 --validation_split=0.2 --width=5 --height=5,0.0260036413547907,32,5,0.2,0.6057,643.4,71,0,None,arbeitsrechner
1739385481,1739385549,68,bash /home/s3811141/repos/OmniOpt/ax/.tests/example_network/run.sh --learning_rate=0.006007097844698412 --epochs=30 --validation_split=0.2 --width=10 --height=10,0.006007097844698412,30,10,0.2,0.9865,635.46,68,0,None,arbeitsrechner
1739385703,1739385810,107,bash /home/s3811141/repos/OmniOpt/ax/.tests/example_network/run.sh --learning_rate=0.017368043644634828 --epochs=50 --validation_split=0.2 --width=15 --height=15,0.017368043644634828,50,15,0.2,1.7995,649.97,107,0,None,arbeitsrechner
1739385936,1739386016,80,bash /home/s3811141/repos/OmniOpt/ax/.tests/example_network/run.sh --learning_rate=0.06984422445911234 --epochs=36 --validation_split=0.2 --width=5 --height=5,0.06984422445911234,36,5,0.2,1.5275,639.55,80,0,None,arbeitsrechner
1739386162,1739386237,75,bash /home/s3811141/repos/OmniOpt/ax/.tests/example_network/run.sh --learning_rate=0.059524757743228414 --epochs=34 --validation_split=0.2 --width=5 --height=5,0.059524757743228414,34,5,0.2,1.0955,647.4,75,0,None,arbeitsrechner
1739386372,1739386462,90,bash /home/s3811141/repos/OmniOpt/ax/.tests/example_network/run.sh --learning_rate=0.061377494531701327 --epochs=41 --validation_split=0.2 --width=10 --height=10,0.061377494531701327,41,10,0.2,1.5257,637.95,90,0,None,arbeitsrechner
1739386609,1739386678,69,bash /home/s3811141/repos/OmniOpt/ax/.tests/example_network/run.sh --learning_rate=0.009836656645299703 --epochs=30 --validation_split=0.2 --width=5 --height=5,0.009836656645299703,30,5,0.2,0.2079,642.25,69,0,None,arbeitsrechner
1739386812,1739386890,78,bash /home/s3811141/repos/OmniOpt/ax/.tests/example_network/run.sh --learning_rate=0.078136350571646 --epochs=35 --validation_split=0.2 --width=10 --height=10,0.078136350571646,35,10,0.2,1.5338,636.06,78,0,None,arbeitsrechner
1739387040,1739387107,67,bash /home/s3811141/repos/OmniOpt/ax/.tests/example_network/run.sh --learning_rate=0.0035516317011588623 --epochs=30 --validation_split=0.2 --width=5 --height=5,0.0035516317011588623,30,5,0.2,0.1987,640.67,67,0,None,arbeitsrechner
1739387247,1739387353,106,bash /home/s3811141/repos/OmniOpt/ax/.tests/example_network/run.sh --learning_rate=0.00991750594419631 --epochs=50 --validation_split=0.2 --width=5 --height=5,0.00991750594419631,50,5,0.2,0.1518,642.21,106,0,None,arbeitsrechner
1739387520,1739387588,68,bash /home/s3811141/repos/OmniOpt/ax/.tests/example_network/run.sh --learning_rate=0.03954354582625361 --epochs=30 --validation_split=0.2 --width=5 --height=5,0.03954354582625361,30,5,0.2,0.919,642.83,68,0,None,arbeitsrechner
1739387753,1739387862,109,bash /home/s3811141/repos/OmniOpt/ax/.tests/example_network/run.sh --learning_rate=0.009076480549987876 --epochs=50 --validation_split=0.2 --width=10 --height=10,0.009076480549987876,50,10,0.2,0.3637,638.11,109,0,None,arbeitsrechner
1739388014,1739388112,98,bash /home/s3811141/repos/OmniOpt/ax/.tests/example_network/run.sh --learning_rate=0.047611426061800306 --epochs=46 --validation_split=0.2 --width=10 --height=10,0.047611426061800306,46,10,0.2,1.5294,637.87,98,0,None,arbeitsrechner
1739388255,1739388354,99,bash /home/s3811141/repos/OmniOpt/ax/.tests/example_network/run.sh --learning_rate=0.006171697163667 --epochs=46 --validation_split=0.2 --width=10 --height=10,0.006171697163667,46,10,0.2,0.6502,637.51,99,0,None,arbeitsrechner
1739388518,1739388607,89,bash /home/s3811141/repos/OmniOpt/ax/.tests/example_network/run.sh --learning_rate=0.08367642101609384 --epochs=40 --validation_split=0.2 --width=10 --height=10,0.08367642101609384,40,10,0.2,1.545,637.74,89,0,None,arbeitsrechner
1739388752,1739388821,69,bash /home/s3811141/repos/OmniOpt/ax/.tests/example_network/run.sh --learning_rate=0.08737331704817765 --epochs=30 --validation_split=0.2 --width=10 --height=10,0.08737331704817765,30,10,0.2,1.5331,636.52,69,0,None,arbeitsrechner
1739388979,1739389047,68,bash /home/s3811141/repos/OmniOpt/ax/.tests/example_network/run.sh --learning_rate=0.06965635638104872 --epochs=30 --validation_split=0.2 --width=10 --height=10,0.06965635638104872,30,10,0.2,1.5285,635.89,68,0,None,arbeitsrechner
1739389185,1739389254,69,bash /home/s3811141/repos/OmniOpt/ax/.tests/example_network/run.sh --learning_rate=0.002618682293731283 --epochs=30 --validation_split=0.2 --width=10 --height=10,0.002618682293731283,30,10,0.2,0.1665,635.71,69,0,None,arbeitsrechner
1739389421,1739389489,68,bash /home/s3811141/repos/OmniOpt/ax/.tests/example_network/run.sh --learning_rate=0.028063068333033087 --epochs=30 --validation_split=0.2 --width=5 --height=5,0.028063068333033087,30,5,0.2,1.5242,644.57,68,0,None,arbeitsrechner
1739389634,1739389742,108,bash /home/s3811141/repos/OmniOpt/ax/.tests/example_network/run.sh --learning_rate=0.0035314147086880705 --epochs=50 --validation_split=0.2 --width=5 --height=5,0.0035314147086880705,50,5,0.2,0.1342,640.95,108,0,None,arbeitsrechner
1739389907,1739389986,79,bash /home/s3811141/repos/OmniOpt/ax/.tests/example_network/run.sh --learning_rate=0.003471279713398495 --epochs=36 --validation_split=0.2 --width=5 --height=5,0.003471279713398495,36,5,0.2,0.2685,641.8,79,0,None,arbeitsrechner
1739390143,1739390211,68,bash /home/s3811141/repos/OmniOpt/ax/.tests/example_network/run.sh --learning_rate=0.003601825961620013 --epochs=30 --validation_split=0.2 --width=10 --height=10,0.003601825961620013,30,10,0.2,0.2027,635.7,68,0,None,arbeitsrechner
1739390379,1739390465,86,bash /home/s3811141/repos/OmniOpt/ax/.tests/example_network/run.sh --learning_rate=0.03867683114157139 --epochs=39 --validation_split=0.2 --width=5 --height=5,0.03867683114157139,39,5,0.2,0.5703,641.72,86,0,None,arbeitsrechner
1739390612,1739390718,106,bash /home/s3811141/repos/OmniOpt/ax/.tests/example_network/run.sh --learning_rate=0.004018343885966241 --epochs=49 --validation_split=0.2 --width=10 --height=10,0.004018343885966241,49,10,0.2,0.6485,637,106,0,None,arbeitsrechner
1739390879,1739390970,91,bash /home/s3811141/repos/OmniOpt/ax/.tests/example_network/run.sh --learning_rate=0.012147941579546313 --epochs=41 --validation_split=0.2 --width=5 --height=5,0.012147941579546313,41,5,0.2,0.3514,635.93,91,0,None,arbeitsrechner
1739391112,1739391181,69,bash /home/s3811141/repos/OmniOpt/ax/.tests/example_network/run.sh --learning_rate=0.019004802059569316 --epochs=30 --validation_split=0.2 --width=10 --height=10,0.019004802059569316,30,10,0.2,1.5231,636.65,69,0,None,arbeitsrechner
1739391343,1739391451,108,bash /home/s3811141/repos/OmniOpt/ax/.tests/example_network/run.sh --learning_rate=0.1 --epochs=50 --validation_split=0.2 --width=10 --height=10,0.1,50,10,0.2,1.5288,638.88,108,0,None,arbeitsrechner
1739391592,1739391666,74,bash /home/s3811141/repos/OmniOpt/ax/.tests/example_network/run.sh --learning_rate=0.010585254302787983 --epochs=32 --validation_split=0.2 --width=10 --height=10,0.010585254302787983,32,10,0.2,0.2242,636.2,74,0,None,arbeitsrechner
1739391840,1739391918,78,bash /home/s3811141/repos/OmniOpt/ax/.tests/example_network/run.sh --learning_rate=0.09696211947409906 --epochs=35 --validation_split=0.2 --width=5 --height=5,0.09696211947409906,35,5,0.2,1.5296,641.55,78,0,None,arbeitsrechner
1739392069,1739392143,74,bash /home/s3811141/repos/OmniOpt/ax/.tests/example_network/run.sh --learning_rate=0.09495456514871457 --epochs=33 --validation_split=0.2 --width=10 --height=10,0.09495456514871457,33,10,0.2,1.536,636.88,74,0,None,arbeitsrechner
1739392311,1739392380,69,bash /home/s3811141/repos/OmniOpt/ax/.tests/example_network/run.sh --learning_rate=0.011252304889077924 --epochs=30 --validation_split=0.2 --width=5 --height=5,0.011252304889077924,30,5,0.2,0.5121,640.97,69,0,None,arbeitsrechner
1739392531,1739392608,77,bash /home/s3811141/repos/OmniOpt/ax/.tests/example_network/run.sh --learning_rate=0.03231159893800427 --epochs=34 --validation_split=0.2 --width=15 --height=15,0.03231159893800427,34,15,0.2,1.525,651.86,77,0,None,arbeitsrechner
1739392783,1739392856,73,bash /home/s3811141/repos/OmniOpt/ax/.tests/example_network/run.sh --learning_rate=0.05883137794355588 --epochs=31 --validation_split=0.2 --width=20 --height=20,0.05883137794355588,31,20,0.2,1.5306,667.44,73,0,None,arbeitsrechner
1739393019,1739393108,89,bash /home/s3811141/repos/OmniOpt/ax/.tests/example_network/run.sh --learning_rate=0.06469437487807998 --epochs=40 --validation_split=0.2 --width=15 --height=15,0.06469437487807998,40,15,0.2,1.5322,648.69,89,0,None,arbeitsrechner
1739393294,1739393364,70,bash /home/s3811141/repos/OmniOpt/ax/.tests/example_network/run.sh --learning_rate=0.08088790866219282 --epochs=30 --validation_split=0.2 --width=15 --height=15,0.08088790866219282,30,15,0.2,1.5244,649.57,70,0,None,arbeitsrechner
1739393526,1739393596,70,bash /home/s3811141/repos/OmniOpt/ax/.tests/example_network/run.sh --learning_rate=0.04911174840260602 --epochs=30 --validation_split=0.2 --width=5 --height=5,0.04911174840260602,30,5,0.2,1.5378,642.24,70,0,None,arbeitsrechner
1739393780,1739393887,107,bash /home/s3811141/repos/OmniOpt/ax/.tests/example_network/run.sh --learning_rate=0.03958473589583656 --epochs=50 --validation_split=0.2 --width=10 --height=10,0.03958473589583656,50,10,0.2,1.5274,637.91,107,0,None,arbeitsrechner
1739394049,1739394119,70,bash /home/s3811141/repos/OmniOpt/ax/.tests/example_network/run.sh --learning_rate=0.09926216675069074 --epochs=30 --validation_split=0.2 --width=15 --height=15,0.09926216675069074,30,15,0.2,1.5309,651.23,70,0,None,arbeitsrechner
1739394299,1739394366,67,bash /home/s3811141/repos/OmniOpt/ax/.tests/example_network/run.sh --learning_rate=0.07812800517201783 --epochs=30 --validation_split=0.2 --width=5 --height=5,0.07812800517201783,30,5,0.2,1.5337,640.49,67,0,None,arbeitsrechner
1739394531,1739394599,68,bash /home/s3811141/repos/OmniOpt/ax/.tests/example_network/run.sh --learning_rate=0.0751530071054935 --epochs=30 --validation_split=0.2 --width=5 --height=5,0.0751530071054935,30,5,0.2,1.53,639.3,68,0,None,arbeitsrechner
1739394790,1739394859,69,bash /home/s3811141/repos/OmniOpt/ax/.tests/example_network/run.sh --learning_rate=0.002187310884080026 --epochs=30 --validation_split=0.2 --width=15 --height=15,0.002187310884080026,30,15,0.2,0.1287,650.98,69,0,None,arbeitsrechner
1739395025,1739395093,68,bash /home/s3811141/repos/OmniOpt/ax/.tests/example_network/run.sh --learning_rate=0.09035267303084227 --epochs=30 --validation_split=0.2 --width=5 --height=5,0.09035267303084227,30,5,0.2,1.5398,641.61,68,0,None,arbeitsrechner
1739395278,1739395349,71,bash /home/s3811141/repos/OmniOpt/ax/.tests/example_network/run.sh --learning_rate=0.07937804095387456 --epochs=30 --validation_split=0.2 --width=10 --height=10,0.07937804095387456,30,10,0.2,1.5282,635.69,71,0,None,arbeitsrechner
1739395509,1739395589,80,bash /home/s3811141/repos/OmniOpt/ax/.tests/example_network/run.sh --learning_rate=0.040205938849578564 --epochs=34 --validation_split=0.2 --width=20 --height=20,0.040205938849578564,34,20,0.2,1.5244,662.98,80,0,None,arbeitsrechner
1739395763,1739395874,111,bash /home/s3811141/repos/OmniOpt/ax/.tests/example_network/run.sh --learning_rate=0.0033824224637341365 --epochs=50 --validation_split=0.2 --width=20 --height=20,0.0033824224637341365,50,20,0.2,0.0441,666.61,111,0,None,arbeitsrechner
1739396033,1739396129,96,bash /home/s3811141/repos/OmniOpt/ax/.tests/example_network/run.sh --learning_rate=0.03749274533103754 --epochs=44 --validation_split=0.2 --width=5 --height=5,0.03749274533103754,44,5,0.2,1.5274,640.03,96,0,None,arbeitsrechner
1739396314,1739396394,80,bash /home/s3811141/repos/OmniOpt/ax/.tests/example_network/run.sh --learning_rate=0.08204046439589632 --epochs=36 --validation_split=0.2 --width=5 --height=5,0.08204046439589632,36,5,0.2,1.5347,638.25,80,0,None,arbeitsrechner
1739396555,1739396665,110,bash /home/s3811141/repos/OmniOpt/ax/.tests/example_network/run.sh --learning_rate=0.06604226929203559 --epochs=50 --validation_split=0.2 --width=10 --height=10,0.06604226929203559,50,10,0.2,1.4995,638.61,110,0,None,arbeitsrechner
1739396825,1739396911,86,bash /home/s3811141/repos/OmniOpt/ax/.tests/example_network/run.sh --learning_rate=0.006862365755711561 --epochs=38 --validation_split=0.2 --width=10 --height=10,0.006862365755711561,38,10,0.2,1.8543,637.7,86,0,None,arbeitsrechner
1739397057,1739397154,97,bash /home/s3811141/repos/OmniOpt/ax/.tests/example_network/run.sh --learning_rate=0.011298067567409201 --epochs=44 --validation_split=0.2 --width=10 --height=10,0.011298067567409201,44,10,0.2,0.4714,637.27,97,0,None,arbeitsrechner
1739397336,1739397410,74,bash /home/s3811141/repos/OmniOpt/ax/.tests/example_network/run.sh --learning_rate=0.02492199017592136 --epochs=32 --validation_split=0.2 --width=15 --height=15,0.02492199017592136,32,15,0.2,0.777,649.73,74,0,None,arbeitsrechner
1739397575,1739397653,78,bash /home/s3811141/repos/OmniOpt/ax/.tests/example_network/run.sh --learning_rate=0.08613863732019218 --epochs=34 --validation_split=0.2 --width=15 --height=15,0.08613863732019218,34,15,0.2,1.5293,652.15,78,0,None,arbeitsrechner
1739397837,1739397912,75,bash /home/s3811141/repos/OmniOpt/ax/.tests/example_network/run.sh --learning_rate=0.0034530158445227077 --epochs=32 --validation_split=0.2 --width=15 --height=15,0.0034530158445227077,32,15,0.2,0.2301,652.99,75,0,None,arbeitsrechner
1739398081,1739398151,70,bash /home/s3811141/repos/OmniOpt/ax/.tests/example_network/run.sh --learning_rate=0.002239352082202501 --epochs=30 --validation_split=0.2 --width=5 --height=5,0.002239352082202501,30,5,0.2,0.164,638.98,70,0,None,arbeitsrechner
1739398332,1739398402,70,bash /home/s3811141/repos/OmniOpt/ax/.tests/example_network/run.sh --learning_rate=0.0016090859544583011 --epochs=30 --validation_split=0.2 --width=10 --height=10,0.0016090859544583011,30,10,0.2,0.148,637.28,70,0,None,arbeitsrechner
1739398584,1739398653,69,bash /home/s3811141/repos/OmniOpt/ax/.tests/example_network/run.sh --learning_rate=0.0031425980149817315 --epochs=30 --validation_split=0.2 --width=5 --height=5,0.0031425980149817315,30,5,0.2,0.1075,643.31,69,0,None,arbeitsrechner
1739398836,1739398930,94,bash /home/s3811141/repos/OmniOpt/ax/.tests/example_network/run.sh --learning_rate=0.003448386482272301 --epochs=41 --validation_split=0.2 --width=20 --height=20,0.003448386482272301,41,20,0.2,0.1583,670.16,94,0,None,arbeitsrechner
1739399127,1739399231,104,bash /home/s3811141/repos/OmniOpt/ax/.tests/example_network/run.sh --learning_rate=0.003258579045002617 --epochs=47 --validation_split=0.2 --width=10 --height=10,0.003258579045002617,47,10,0.2,0.191,637.68,104,0,None,arbeitsrechner
1739399440,1739399516,76,bash /home/s3811141/repos/OmniOpt/ax/.tests/example_network/run.sh --learning_rate=0.0032306301995963984 --epochs=33 --validation_split=0.2 --width=10 --height=10,0.0032306301995963984,33,10,0.2,0.2182,636.85,76,0,None,arbeitsrechner
1739399716,1739399807,91,bash /home/s3811141/repos/OmniOpt/ax/.tests/example_network/run.sh --learning_rate=0.0032719129521014013 --epochs=41 --validation_split=0.2 --width=5 --height=5,0.0032719129521014013,41,5,0.2,0.184,646.06,91,0,None,arbeitsrechner
1739400010,1739400118,108,bash /home/s3811141/repos/OmniOpt/ax/.tests/example_network/run.sh --learning_rate=0.0031246204358994123 --epochs=50 --validation_split=0.2 --width=5 --height=5,0.0031246204358994123,50,5,0.2,0.2107,643.29,108,0,None,arbeitsrechner
1739400325,1739400397,72,bash /home/s3811141/repos/OmniOpt/ax/.tests/example_network/run.sh --learning_rate=0.0032215541256867155 --epochs=30 --validation_split=0.2 --width=10 --height=10,0.0032215541256867155,30,10,0.2,0.1621,636.64,72,0,None,arbeitsrechner
1739400608,1739400691,83,bash /home/s3811141/repos/OmniOpt/ax/.tests/example_network/run.sh --learning_rate=0.02494586029928525 --epochs=37 --validation_split=0.2 --width=10 --height=10,0.02494586029928525,37,10,0.2,1.0059,637.56,83,0,None,arbeitsrechner
1739400885,1739400957,72,bash /home/s3811141/repos/OmniOpt/ax/.tests/example_network/run.sh --learning_rate=0.003087081736064603 --epochs=30 --validation_split=0.2 --width=15 --height=15,0.003087081736064603,30,15,0.2,0.1071,649.79,72,0,None,arbeitsrechner
1739401171,1739401241,70,bash /home/s3811141/repos/OmniOpt/ax/.tests/example_network/run.sh --learning_rate=0.1 --epochs=30 --validation_split=0.2 --width=10 --height=10,0.1,30,10,0.2,1.5376,636.08,70,0,None,arbeitsrechner
1739401430,1739401541,111,bash /home/s3811141/repos/OmniOpt/ax/.tests/example_network/run.sh --learning_rate=0.010976370044489243 --epochs=50 --validation_split=0.2 --width=5 --height=5,0.010976370044489243,50,5,0.2,0.1676,640.79,111,0,None,arbeitsrechner
1739401755,1739401847,92,bash /home/s3811141/repos/OmniOpt/ax/.tests/example_network/run.sh --learning_rate=0.003333836127305363 --epochs=41 --validation_split=0.2 --width=10 --height=10,0.003333836127305363,41,10,0.2,0.1442,637.83,92,0,None,arbeitsrechner
1739402057,1739402131,74,bash /home/s3811141/repos/OmniOpt/ax/.tests/example_network/run.sh --learning_rate=0.0032966061428218196 --epochs=33 --validation_split=0.2 --width=5 --height=5,0.0032966061428218196,33,5,0.2,0.1846,641.34,74,0,None,arbeitsrechner
1739402359,1739402428,69,bash /home/s3811141/repos/OmniOpt/ax/.tests/example_network/run.sh --learning_rate=0.08599758048808327 --epochs=30 --validation_split=0.2 --width=5 --height=5,0.08599758048808327,30,5,0.2,1.5306,637.86,69,0,None,arbeitsrechner
1739402626,1739402737,111,bash /home/s3811141/repos/OmniOpt/ax/.tests/example_network/run.sh --learning_rate=0.07512353148937018 --epochs=50 --validation_split=0.2 --width=15 --height=15,0.07512353148937018,50,15,0.2,1.5268,651.07,111,0,None,arbeitsrechner
1739402931,1739403001,70,bash /home/s3811141/repos/OmniOpt/ax/.tests/example_network/run.sh --learning_rate=0.03887263374192138 --epochs=30 --validation_split=0.2 --width=10 --height=10,0.03887263374192138,30,10,0.2,1.5275,636.2,70,0,None,arbeitsrechner
1739403179,1739403251,72,bash /home/s3811141/repos/OmniOpt/ax/.tests/example_network/run.sh --learning_rate=0.03384303775397006 --epochs=30 --validation_split=0.2 --width=10 --height=10,0.03384303775397006,30,10,0.2,1.5269,636.46,72,0,None,arbeitsrechner
1739403477,1739403548,71,bash /home/s3811141/repos/OmniOpt/ax/.tests/example_network/run.sh --learning_rate=0.0601479165738255 --epochs=30 --validation_split=0.2 --width=10 --height=10,0.0601479165738255,30,10,0.2,1.5343,636.09,71,0,None,arbeitsrechner
1739403743,1739403813,70,bash /home/s3811141/repos/OmniOpt/ax/.tests/example_network/run.sh --learning_rate=0.0836857238343279 --epochs=30 --validation_split=0.2 --width=10 --height=10,0.0836857238343279,30,10,0.2,1.5509,636.22,70,0,None,arbeitsrechner
1739404008,1739404078,70,bash /home/s3811141/repos/OmniOpt/ax/.tests/example_network/run.sh --learning_rate=0.09744059547170107 --epochs=30 --validation_split=0.2 --width=10 --height=10,0.09744059547170107,30,10,0.2,1.5284,636.38,70,0,None,arbeitsrechner
1739404272,1739404344,72,bash /home/s3811141/repos/OmniOpt/ax/.tests/example_network/run.sh --learning_rate=0.05229776684280211 --epochs=30 --validation_split=0.2 --width=10 --height=10,0.05229776684280211,30,10,0.2,1.5266,636.5,72,0,None,arbeitsrechner
1739404555,1739404626,71,bash /home/s3811141/repos/OmniOpt/ax/.tests/example_network/run.sh --learning_rate=0.09014132295343172 --epochs=30 --validation_split=0.2 --width=10 --height=10,0.09014132295343172,30,10,0.2,1.532,636.11,71,0,None,arbeitsrechner
1739404831,1739404916,85,bash /home/s3811141/repos/OmniOpt/ax/.tests/example_network/run.sh --learning_rate=0.0032642265452236933 --epochs=37 --validation_split=0.2 --width=10 --height=10,0.0032642265452236933,37,10,0.2,0.1555,637.45,85,0,None,arbeitsrechner
1739405141,1739405225,84,bash /home/s3811141/repos/OmniOpt/ax/.tests/example_network/run.sh --learning_rate=0.0975593743815375 --epochs=37 --validation_split=0.2 --width=10 --height=10,0.0975593743815375,37,10,0.2,1.5294,637.45,84,0,None,arbeitsrechner
1739405439,1739405525,86,bash /home/s3811141/repos/OmniOpt/ax/.tests/example_network/run.sh --learning_rate=0.0033217848450569033 --epochs=38 --validation_split=0.2 --width=5 --height=5,0.0033217848450569033,38,5,0.2,0.1422,642.74,86,0,None,arbeitsrechner
1739405743,1739405812,69,bash /home/s3811141/repos/OmniOpt/ax/.tests/example_network/run.sh --learning_rate=0.011493934325979428 --epochs=30 --validation_split=0.2 --width=10 --height=10,0.011493934325979428,30,10,0.2,0.4558,635.76,69,0,None,arbeitsrechner
1739406035,1739406137,102,bash /home/s3811141/repos/OmniOpt/ax/.tests/example_network/run.sh --learning_rate=0.00333709642893409 --epochs=45 --validation_split=0.2 --width=15 --height=15,0.00333709642893409,45,15,0.2,0.1316,652.98,102,0,None,arbeitsrechner
1739406358,1739406431,73,bash /home/s3811141/repos/OmniOpt/ax/.tests/example_network/run.sh --learning_rate=0.0033458929791574557 --epochs=31 --validation_split=0.2 --width=10 --height=10,0.0033458929791574557,31,10,0.2,0.2762,635.96,73,0,None,arbeitsrechner
1739406636,1739406708,72,bash /home/s3811141/repos/OmniOpt/ax/.tests/example_network/run.sh --learning_rate=0.05615034344888885 --epochs=30 --validation_split=0.2 --width=10 --height=10,0.05615034344888885,30,10,0.2,1.5235,636.13,72,0,None,arbeitsrechner
1739406923,1739406993,70,bash /home/s3811141/repos/OmniOpt/ax/.tests/example_network/run.sh --learning_rate=0.04620234349160212 --epochs=30 --validation_split=0.2 --width=10 --height=10,0.04620234349160212,30,10,0.2,1.5256,635.58,70,0,None,arbeitsrechner
1739407206,1739407278,72,bash /home/s3811141/repos/OmniOpt/ax/.tests/example_network/run.sh --learning_rate=0.09556491841200652 --epochs=31 --validation_split=0.2 --width=10 --height=10,0.09556491841200652,31,10,0.2,1.5494,635.75,72,0,None,arbeitsrechner
1739407506,1739407580,74,bash /home/s3811141/repos/OmniOpt/ax/.tests/example_network/run.sh --learning_rate=0.003243055280633622 --epochs=32 --validation_split=0.2 --width=10 --height=10,0.003243055280633622,32,10,0.2,0.1856,636.54,74,0,None,arbeitsrechner
1739407783,1739407859,76,bash /home/s3811141/repos/OmniOpt/ax/.tests/example_network/run.sh --learning_rate=0.025144652398517226 --epochs=32 --validation_split=0.2 --width=10 --height=10,0.025144652398517226,32,10,0.2,1.5242,635.98,76,0,None,arbeitsrechner
1739408089,1739408159,70,bash /home/s3811141/repos/OmniOpt/ax/.tests/example_network/run.sh --learning_rate=0.03206352200520285 --epochs=30 --validation_split=0.2 --width=10 --height=10,0.03206352200520285,30,10,0.2,0.6501,636.67,70,0,None,arbeitsrechner
1739408392,1739408466,74,bash /home/s3811141/repos/OmniOpt/ax/.tests/example_network/run.sh --learning_rate=0.018145437004921182 --epochs=31 --validation_split=0.2 --width=10 --height=10,0.018145437004921182,31,10,0.2,0.6666,636.54,74,0,None,arbeitsrechner
1739408696,1739408767,71,bash /home/s3811141/repos/OmniOpt/ax/.tests/example_network/run.sh --learning_rate=0.035718737655171716 --epochs=30 --validation_split=0.2 --width=10 --height=10,0.035718737655171716,30,10,0.2,1.527,636.27,71,0,None,arbeitsrechner
1739409005,1739409085,80,bash /home/s3811141/repos/OmniOpt/ax/.tests/example_network/run.sh --learning_rate=0.003433096492675667 --epochs=34 --validation_split=0.2 --width=10 --height=10,0.003433096492675667,34,10,0.2,0.2,636.69,80,0,None,arbeitsrechner
1739409337,1739409413,76,bash /home/s3811141/repos/OmniOpt/ax/.tests/example_network/run.sh --learning_rate=0.032259547809843206 --epochs=33 --validation_split=0.2 --width=10 --height=10,0.032259547809843206,33,10,0.2,1.5273,636.55,76,0,None,arbeitsrechner
1739409648,1739409719,71,bash /home/s3811141/repos/OmniOpt/ax/.tests/example_network/run.sh --learning_rate=0.04053588058001525 --epochs=30 --validation_split=0.2 --width=10 --height=10,0.04053588058001525,30,10,0.2,1.5245,635.05,71,0,None,arbeitsrechner
